Word: translater: audio
handle: manejo : /'han-d_ol/
flesh: carne: /flesh/
flesh out: dar mas cuerpo, detallar: /flesh aut/
develop: desarrollar: /di-'ve-l_op/
issue: emitir: /'is-ju/
requests: solicitudes: /ri-'kwest/
requirement: requerimiento: /ri-kwar-'m_ent/
expose: exponer: /ik-'spounz/
sample: muestra: /'sam-p_ol/
retrieve: recuperar: /re-'triv/
maintains: mantener: /'mein-'tein/
less: menor: /les/
greater: mayor: /'grei-rer/
slice: rebanar: /slais/
nest: anidar: /nest/
curly braces: llaves: /'kor-li breices/
quotes: comillas: /cou-'tes/
instead: en lugar de : /en-'sted/
attribute: atributo: /'a-tri-biu/
upwards: hacia arriba: /'ap-w_edz/
closets: mas cercano: /'kla-zet/
either: cualquiera de los dos: /'ai-der/
able: capaz: /'ei-bl/
you're welcome: de nada : /ior 'wel-ke_n/
to kind of : mas o menos, como que, en cierto modo / to kaidaf/
picture: cuadro : /'pik-cha_/
coin: moneda: /koin/
resolve: resolver: /ri-'zolv/
reject: rechazar: /ri-'jeck/
pending: pendiente: /'pen-ding/
were: fui pasado de to be : /we_/
where: donde: /wer/
lay: colocar: /lei/
paradigm: paradigma: /'pe-ra-daim/




