Word: translater: audio
JavaScritp: JavaScript : /'ya-va-skrip/
Reat: React: /ri-'act/
promise / promises: promesa , promesas : /'pra-mis/ /'pra-mises/
Async : asincronico : /éiu-sink/
pure function: funciones pura : /pi-'ur 'fank-shon/
functional programming: programar funcional: /'fank-shonal 'pro-graming/
reactive programming: pragramar reactive: /ri-'act 'pro-graming/
closure: cierre: /'klou-sher/
callback: llamada hacia atras: /'col-bak/
arquitecture: arquitectura : /'ar-ki-tek-cher/
unit testing: probar unidad: /'iu-nit 'tes-ting/
git: git: /guit/
context API: API de contexto: /'kan-text ei-pi-ai/
Next.JS: Next.JS : /'nekst y'ei-'es/
scope: ámbito: /skoup/
often: a menudo, con frecuencia : /'aften/
senior: superior o mayor rango: /'si-nier/
bug: bicho, error, infeccion: /bag/
click: click: /cleck/
quantity: cantidad: /'kuan-re-ri/
far: lejos: /far/
message: mensage: /'me-seg/
false: falso: /fols/
link: link: /lengk/
brave: valiente: /breiv/
tied: atar: /tai/
copy: copiar: /'ca-py/
take: tomar,llevar , recibir, tardar: /teik/
take out: sacar, quitar : /teik aut/
solve: resolver: /'sav/
issue: asunto : /'i-chu/
misalingned: desalinueado: /misa-'lained/
resolve: resolver: /ri-'solv/
reject: rechazar: /ri-'jakt/
response: respuesa: /ri-'spons/
Domain-Driven Design:  Diseño guiado por el Dominio : /dou-'mein 'dre-ven di-'zain/
Bounded Context: contexto delimitado: / baunded 'kan-teks /
billing: facturando : /billing/
invoice: facturar : /in-'vois/
amount: cantidad: /_a-'maunt/
paid: pagado: /peid/
active account: cuenta activa: /ak-'tiv e-'kaunt/
properties: propiedades: /'pra-pe-tis/
model: modelo: /'ma-del/
withdraw: retirar: /ui-dra/
deposit: depositar: /de-´pa-zit/
quantity: cantidad: 'kuan-te-ti/
overloading: sobrecarga: /ou-ve-'louding/
Command Query Responsibility Segregation: Segregacion de Responsabilidad entre Comando y Consulta: /ka-'mend query res-pon-sa-'be-liri/ segre-'ge-chon/

  


