Word: translater: audio
library: libreria: /'lai-bre-ri/
party: parte o fiesta : /'pa-ri/
neighborhood: vecindario : /'nei-bor-ju/
laugh: reir: /laf/
sun: sol : /san/
explain: explicar: /ex-'plein/
neighbor: vecino: //
challenge: desafio: /'cha-leng/
disappointment: decepcion: /dis-_a'pont-m_ent/
authorized: autorizado: /'a-z_e-rais/
such as: como : /sach/
search: buscar: /surch/
feast: fiesta o festin o banquete : /fist/
sea: mar ; /si/
travel: viaje: /'tr_a-vl/
swedish: sueco: /'sui-desh/
sweden: suecia: /sue-den/
avenue: avenida: /'a-ve-niu/
becomes: comenzar o volverse : /be-'cam/
just: solo : /yast/
stepping : paso o etapa: /staping/
reality : realidad : /ri-'ale-ri/
carefully: cuidadosamente : /'ker-f_eri/
forever: para siempre : /for-'re-v_er/
something: algo : /'sam-zing/
ignite: prender o encender : /ig-'nait/
proud: orgulloso: /praud/
achieved: logrado o alzanzado : /_a-'chif/
luck: suerte o casualidad : /lack/
come: venir /kam/
long: largo o mucho tiempo: /long/
ambiguty
intricate
articulate
ingenuity
resilence
altruism
introspection
meticulous
inevitable
ephemeral
serendipity
austerity
vindicate
omnipotent
perpicacious